XXXXXXXXXXXXXXXXXXXXXXXXXXXXXXXXXXXXXXXXXXXXXXXXXXXXXX..XXXXXXXXXXXXXXXXXXXXXXXXXXXXXXXJ*,t,,,,,XXXXXXXXXXXXXXXXXXXXXXXXXXXXXXXXXXXXXXXXXXXXXXXXXXXXXXXXXXXXXXXXXXXXXXXXXXXXXXXXXXX
XXXXXXXXXXXXXXXXXXXXXXXXXXXXXXXXXXXXXXXXXXXXXXXXXXXXXX.H.,.,.,JJXXXXXXXXXXXXXXXXXXXXXXX.,,,,,,..XXXXXXXXXXXXXXXXXXXXXXXXXXXXXXXXXXXXXXXXXXXXXXXXXXXXXXXXXXXXXXXXXXXXXXXXXXXXXXXXXXX
XXXXXXXXXXXXXXXXXX.,.,.,.,.,.,XXXXXX.,.,.,.,.,.,.XXX,,.,.,.,.,.mXXXXXXXXXXXXXXXXXXXXXXXXXXXXXX..XXXXXXXXXXXXXXXXXXXXXXXXXXXXXXXXXXXXXXXXXXXXXXXXXXXXXXXXXXXXXXXXXXXXXXXXXXXXXXXXXXX
XXXXXXXXXXXXXXXXXXJ.,.,.,.,.,.#XXXXt,.,.,.,.,.,.,XXXt,.,.CCXXXXX.....m.................................X.........................XX,,,,..............XXXX,,,,XXXX,,,,,,,XX,,,,,,,,X
XXX.,.,.,.,.,.,.XX...,.,.,.,.,.,XXX.,.,.,.,.,.,.,XXX.,.,.,,.,..,...t.........................,,......B.X.........................XXJJJ,H.............,,#,,,,,XXXX,,,,,,,XXA,,,,t,,X
XXX@,.,.,.,.,.,.XXX.,.,.,.,.,.XXXXXXXXCC.,.,.,.,.,XXXC.,.,.,.,.,...................CC........D.........X.........................XX............C.....,,,,,,,,,,XX,,,,,,,XX,,,,,,*JX
X.,.,.,.,.,.,.,.X.,.,.,XX.,.,.,.XXX.,.,.,.,.XX.,.,.,.,.,.,...,,XXXXXXX.................................X.........................XXXXXXXC............XXXX,B,,,,XX,,,,,,,XXB,,,,,,,X
X.,.,.,.,.,.,.,.X.,.,.,.,.,.,.,.XXX.,.,.,.,.,.,.,.,.,.,.,.,,SSXXXXXXXX........XX..................C....X.............................XX..............XXXX,,,,,,XX,,,,,,,XX,,,,,XXXX
X.,.,.,.,.,.,.,.X.,.,.,.,.,.,CCXXXC,.,.,.,.,.,.,.,.,.,.,.,,CCXXXXXXXXXXX...............................X.............................XX................XX,,,,,,CX,,,,,,,XX,,,,,,XXX
X...,.,.,.,.,.,.X.,.,.,t,.,.,.,.XXX.,.,.XXXXXXXXXXXXXXXXXXXXXXXXXXXXXXXXXX...............XXXXX.........X..............................#...............JXX,,,,X,,X,,,,,,,XX,,,C,,XXX
X.,.....,.,t.,.,XX.,.,.,.,.,.,.,XXX.,.,.XXXXXXXXXXXXXXXXXXXXXXXXXXXXXXXXXXX..............XXXXX.........X...........................................t...XX,,,,X,,X,,,,,,,,,,,,,,,XXX
X,.,,...,.,.,.,.X.,.,.XXXXX.,.,.XXXXX.,.,.,.,.,.,.,XXXXXXXXXXXXXXXXXXXXXXXXX.......XX..................X.................B.....C.....XXX.....SSS.....XXXX,,,,X,,X,,,,,,,,,,,,,,,XXX
X.,.,.,,..,.,#,JX.,.,.XXXX.,.,.,XXX.,.,.,.,.,.,.,.,XXXXXXXXXXXXXXXXXXXXXXXXXX..........................X....R....R.....C.,X....B.....XXXXX.m......WXXXXXX,,,,XC,,,,,,,,,,C,,,,,,XXX
XXXXX.,,,.,S,.,.X.,.,.XXXX.,.,CXXXX.,.,.,.,.,.,.,.,XXXXXXXXXXXXXXXXXXXXXXXXXXX.........................B......t......C,,.,XJ...,...MJXXXXX.........XXXXXX,,,,XX,,,,,,,,,DX,,,,,,XXX
XXXXXXXXX...,XXXX.,.,CXXXX.,.,.,XXXXX.,.,.,.,.R.,.,XXXXXXXXXXXXXXXXXXXXXXXXXXXX......................................C,..,X..........XXXXXXXXXXXXXXXXCCCX,,,,XXXX,,,,,,,DX,,,,,CXXX
XXXXXXXXX*,.,XXXX.,.,.XXXX.,.,S,XXX.,.,.,.,.,.,.,.WXXXXXXXXXXXXXXXXXXXXXXXXXXXXXXXXXXXX.............................CC,D,,XXXXXXXXXXXXXXXXXXXXXXXXXXXXX..,,,,XXXX,,,,,,,XX,,,,,,XXX
XXXXXXXXX.,.,.XXX.,.,.XXXXC.,.S.XXX.,.,.,.,.,.,.,.,.,.,.,.,XXXXXXXXXXXXXXXXXXXXXXXXXXXX................XXXXXXXXXXXXX..A..XXXXXXXXXXXXXXXXXXXXXXXXXXXXXX..,,,,XXXX,,,,,,,XX,,,,,,XXX
XXXXXXXXXX.,.,XCXC.,.,XXXXXC.,.,XXXXX.,.,.,.,.,.,.,.,.,.,.,XXXXXXXXXXXXXXXXXXXXXXXXXXXXC......B.......,XXXXXXXXXXXXXSS..SSXXXXXXXXXXXXXXXXXXXXXXXXXXXXX..,,,,XXXX,,,,,,,XXC,,,,,XXX
XXXX.,.,.,.,.M.XX.,.,CXXXX.,.,..XXX.,.,.,.#.,.,t,.,.,.,.,.,XXXXXXXXXXXXXXXXXXXXXXXXXXXX................DDCDDCCDCDDDDSS..SSXXXXXXXXXXXXXXXXXXXXXXXXXXXXX..,,,,,,,,,,,,,,,,,,,,,,,XXX
XXX.,.,.,.,.,.XXX.,.,.XXXX.,.,.,XXX.,S,.,.,.,.,.,.,.,.,.,.,XXXXXXXXXXXXXXXXXXXXXXXXXXXX.S..C,.,.,C.A...,.,...............................................,,,,,,,,,,,,,,,,,,,,,,,XXX
XX.,.,.,.,.,XXXXX.,.,.XXXX.,.,CXXXX.,.,.,XXXXXXXXXX.,.,.,.,.,.,...XX..............................S,.....,...............................................,,.,,,,,,,,,,,,,,,,,,,CXXX
X.,.,.,.,.,XXXXXXC.,.,XXXX.,.,.,XCX.,.,.,XXXXXXXXXXX.,.,.,.,.,.,..XX...................................C.,...............t...............................,,,,,,,,,,,,,t,,,,,,,,,XXX
Xt,.,CCXXXXXXXX.,.,.,XXXXXX.,.,.,.,S,.,.XXXXXXXXXXXX.,.,.,.,.,....XX.............................t.......,......,,.,.....................................,,,,,,,,,,,,,,,,,,,,,,,XXX
X.,,,.,.,.,.,.,.,.,.,.XXX.,.,.,.,.,.,.,.XXXXXXXXXXXXXX.,.,.,.,.,..XX................................S....,...XXXXXXXXXXXXXXX......CXX......C......C.....XXXXXXXXXXXXXXXXXXX,,,,,XXX
XX.,.,.,.,.,.B.,.,.,.,XXXt,A,.XXXX.,.,.,XXXXXXXXXXXXXXX.,.,.,.,...XX....B...................XXXXXXXXMXX..,..,XX...,..................,...................,,,,,,,,XD,,,,,,,,,,S,,XXX
XXX.,.,.,.,.,.,.,.,.XXXXX.,,,.,.XXXXXXXXXXXXXXXXXXXXXXXX.,.,.,.,..XX..................B..B.RXJJJJJJJJJXS.,..XXX...,........................B.............,,,,,,,,XX,,,,,,,,,,,,,XXX
XXXXX.,.,.,.,.,.W.XXXXXXXXC.,.,.XXXXXXXXXXXXXXXXXXXXXXXXX.,.,t,.............#......CCC......X.,.,.,.,.X.S.,,XXX.W........................WJDJ...W........,,,W,,,,XXJM,,,,,,,,,,JXXX
XXXXX.,.,.,.,.,.,XXXXXX.,.,.S.,.XXXXXXXXXXXXXXXXXXXXXXXXXX.,.,.,...................CDDDDDDD.XXXXXXXXXXX..S.SXDD...........................,D.............,,,,,,,,DX,,,,,,,,C,,C,XXX
XXXXXXXXXXXXXXXXXXXXXH,.,.,.,XXXXXXXXXXXXXXXXXXXXXXXXXXXXXXXXXXXYYCCYXYXXXXXXXXX...XXXXXXXXXXXXXXXXXXXXXXXXXXXXXXXXXXXXXXXXXXXXXXXXXXXXXXXXXXXXXXXXXXXXXXXXXXXXXXXXXXXXXXXXX,,XXXXX
XXXXXXXXXXXXXXXXXXXXX,,.XXX.,XXXXXXXXXXXXXXXXXXXXXXXXXXXXXXXXY,,,,,,,,,,,XXXXX,,,,,,,XXXXXXXXXXXXXXXXXXXXXXXXXXXXXXXXXXXXXXXXXXXXXXXXXXXXXXXXXXXXXXXXXXXXXXXXXXXXXXXXXXXXXXXS,XXXXX
YYYYYYYYYYYYYYYYYYYYYYYYYYY.,YYYYYYYYYYYYYYYYYYYYYYYYYYYYYY.,,,,,,,,,,,,,XXXX,.,.,C.,,XXXXX.,.,.,.,.,.,.,.YYYYYYYYYYYYYYYYYYYYYYYYYYYYYYYYYYYYYYYYYYYYYYYYYYYYYYYYYYYYYYYYYY.,YYYYY
D.,.,.,.,.,.,.,.,.,.,.,.,.,.,.,.,.,.,.,.,.YYYYYYYYYYYYYYYYY,.,.,W,.,.,.W.,.,.,mC.Sm,.mB.,.,.,.,.,.,.,.,.,HYYR.,.,.,.,...,.,.,.,.,.,.,.,t,.,.,.,.,.,.,.,.,.R.,.S..S..S...S..,#.,XXXX
D.,.,.,.,.,,,.,.,.,.,.,.,.,.,.,.,.,.,.,.,.YYYYYYYYYYYYYYYY,.XJ.,.,.,.t.,.,.,.,.,.,.,.,.,.,.,.,.,.,.,.,.,.,YY,.,.,.,.,.,.,.,.,.,.,.,.,.,.,.,.,.,.,.,.,.,.,.,.,........K.....,..,XXXX
D.,.,.,.,.,.,.,.,.,.,.,.,.,.,.,.,.,.,.,.,.YY.,.,.,.,.,.,.,.,..,.,.,.,.,.,.,.,.,.,.,.,.,.,.,,.,.,.,,C.,.,.CYYS.SDSDSXXXXXXXXXXXXXXXXXXXXXXXXXXXXXXXXXXXXXXXXXX.............XXDXXXXXX
D.*B,.,.,.,.,.,.,.,.,.,.,.,.,.,.,.,B,.,.,.,..,.,.,.B.,.,.,..DDDDDDDDDDDDDDDDDDDDDDDDD.,.,.,.C.,.,.,.,.,.,.YY,.,.,.,.,.,.,.,.,.,CC.,.D.,.C.,.,X,D,.WXXXXXXXXX,XXXXXXXXXXXXX....WXXXX
D.,.,.,.,.,.,.,.,.,.,.,.,.,.,.,.,.,.,.,.,.,..,.,.,.,.,.B.,.XD.,.,.,.,.,.,.,.,.,.,.,.DD.,.,.,.,.,.,.,.,.,.,YY,.,.,.,.,.,.,.,.,.,,,XXX,.B...X.D.,X,.,XXXXXXXX,,.......,..........XXXX
DSDSDSD,,B,.,.,.,.,.,,.B...,.,.,.,,.,...,.YY.,.M.,.,.,.,.,.,,.,.,t.,.,.,.M.,.,.,T.,JDDD.,.,.,.,.,.,.,.,.,MYY.,DSDS,.,.,.,.,.,.,.,.,.,.t.T.,.,.,.,.,.,.,.,.,.,.t........,..W..E.XXXX
DJ,J,J,.,.,.,.,.,...,.,.,.,.,.,.,.,.,.,.,JYY.,.,.,.,.,.,.,.,,.,.,.,.,.,.,.,.,.,.,.,.DDDD.,.,.,.,.,.,.,.,.,YYS.,.,JC.,.,.,.,.,.,.,.,.,.,.,.,.,.,.,.,.,.,.,.,.,................ .XXXX
D.,.,.,.,.,.,.,.,.,.,.,.,.,.,.,.,.,.,.,.,.YYYYYYYYYYYYYYYDDDDDDYYYYYYYYYYYYYYYYYYYYYYYYYYYYYYYYYYYYYYYYYYYDDS,,,,,,YYYYYYYYYYYYYYYYYYYYYYYYYYYYYYYYYYYYYYYYYYYYYYYYYYYYYYYYYYYYYYYY
YYYYYYYYYYYYYYYYYYYYYYYYYYYYYYYYYYYYYYYYYYYYYYYYYYYYYYYYYYYYYYYYYYYYYYYYYYYYYYYYYYYYYYYYYYYYYYYYYYYYYYYYYYYYYYYYYYYYYYYYYYYYYYYYYYYYYYYYYYYYYYYYYYYYYYYYYYYYYYYYYYYYYYYYYYYYYYYYYYY