FZFFZFZFFZFZFFZFZFFZFZFFZFZFFZFZFFZFZFFZFZFFZFZFFZFZFFZFZFFZFZFFZFZFFZFZFFZFZFFZFZFFZFZFFZFZFFZFZFFZFZFFZFZFFZFZFFZFZFFZFZFFZFZFFZFZFFZFZFFZFZFFZFZFFZFZFFZFZFFZFZFFZFZFFZFZFFZFZFFZFFZFFZFZFFZFZFFZFZFFZFZFFZFZFFZFZFFZFZFFZFZFFZFZFFZFZFFZFZFFZFZFFZFZFFZFZFFZFZFFZFZFFZFZFFZFZFFZFZFF
FZFFZFZFFZFZFFZFZFFZFZFFZFZFFZFZFFZFZFFZFZFFZFZFFZFZFFZFZFFZFZFFZFZFFZFZFFZFZFFZFZFFZFZFFZFZFFZFZFFZFZFFZFZFFZFZFFZFZFFZFZFFZFZFFZFZFFZFZFFZFZFFZFZFFZFZFFZFZFFZFZFFZFZFFZFZFFZFZFFZFFZFFZFZFFZFZFFZFZFFZFZFFZFZFFZFZFFZFZFFZFZFFZFZFFZFZFFZFZFFZFZFFZFZFFZFZFFZFZFFZFZFFZFZFFZFZFFZFZFF
FZFFZFZFFZFZFFZFZFFZFZFFZFZFFZFZFFZFZFFZFZFFZFZFFZFZFFZFZFFZFZFFZFZFFZFZFFZFZFFZFZFFZFZFFZFZFFZFZFFZFZFFZFZFFZFZFFZFZFFZFZFFZFZFFZFZFFZFZFFZFZFFZFZFFZFZFFZFZFFZFZFFZFZFFZFZFFZFZFFZFFZFFZFZFFZFZFFZFZFFZFZFFZFZFFZFZFFZFZFFZFZFFZFZFFZFZFFZFZFFZFZFFZFZFFZFZFFZFZFFZFZFFZFZFFZFZFFZFZFF
FZFFZFZFFZFZFFZFZFFZFZFFZFZFFZFZFFZFZFFZFZFFZFZFFZFZFFZFZFFZFZFFZFZFFZFZFFZFZFFZFZFFZFZFFZFZFFZFZFFZFZFFZFZFFZFZFFZFZFFZFZFFZFZFFZFZFFZFZFFZFZFFZFZFFZFZFFZFZFFZFZFFZFZFFZFZFFZFZFFZFZZZZZZZZZZZZZZZZZZZZZZZZZZZZZZZZZZZZZZZZZZZZZZZZZZZZZZZZZZZZZZZZZZZZZZZZZZZZZZZZZZZZZZZZZZZZZZZZZZZ
FZFFZFZFFZFZFFZFZFFZFZFFZFZFFZFZFFZFZFFZFZFFZFZFFZFZFFZFZFFZFZFFZFZFFZFZFFZFZFFZFZFFZFZFFZFZFFZFZFFZFZFFZFZFFZFZFFZFZFFZFZFFZFZFFZFZFFZFZFFZFZFFZFZFFZFZFFZFZFFZFZFFZFZFFZFZFFZFZFFZFZZZZZZZZZZZZZZZZZZZZZZZZZZZZZZZZZZZZZZZZZZZZZZZZZZZZZZZZZZZZZZZZZZZZZZZZZZZZZZZZZZZZZZZZZZZZZZZZZZZ
FZFFZFZFFZFZFFZFZFFZFZFFZFZFFZFZFFZFZFZ..FZFFZFZFFZFZFFZFZFFZFZFFZFZFFZFZFFZFZFFZFZFFZFZFFZFZFFZFZFFZFZFFZFZFFZFZFFFFFFFFFZFFZFZFFZFZFFZFZFFZFZFFZFZFFZFZFFZFZFFZFZFFZFZFFZFZFFZFZFZZZZZZZZZZ..ZZZSZZZZZZZZZZZZZZZZZZZZZZZZZZZZZZZZZZZZZZZZZZZZZZZZZZZZZZZZZZZZZZZZ.ZZZZZZZZZZZZZZZZZZZZ
FZFZ,.,.,.,.,.,.,.,!,.,..,.,.,.,.,.,.,.,,.,.,.,.,.,.,.,,.,.,.,.,.,.,.,,.,.,.,.,.,.,.,,.,.,.,.,.,.,.,,.,.,.,.,.,.,.,,.,.,.,.,.,.,.,,.,.,.,.,.,.,.,,.,.,.,.,.,.,.,,.,.,.,.,.,.,.,,.,.,.,.,.,.,.,,.,.,.,.,.,.,.,,.,.,.,.,.,.,.,,.,.,.,.,.,.,.,,.,.,.,.,.,.,.,,.,.,.,.,.,.,.,,.,.,.,.,.,.,.,
FZFZ,.,.,.,.,.,.,.,.,.,..,.,.,.,.,.,.,.,,.,.,.,.,.,.,.,,.,.,.,.,.,.,.,,.,.,.,.,.,.,.,,.,.,.,.,.,.,.,,.,.,.,.,.,.,.,,.,.,.,.,.,.,.,,.,.,.,.,.,.,.,,.,.,.,.,.,.,.,,.,.,.,.,.,.,.,,.,.,.,.,.,.,.,,.,.,.,.,.,.,.,,.,.,.,.,.,.,.,,.,.,.,.,.,.,.,,.,.,.,.,.,.,.,,.,.,.,.,.,.,.,,.,.,.,.,.,.,.,
FZFZ,.,.,.,.,.,.,.,.,.,..,.,.,.,.,.,.,.,,.,.,.,.,.,.,.,,.,.,.,.,.,.,.,,.,.,.,.,.,.,.,,.,.,.,.,.,.,.,,.,.,.,.,.,.,.,,.,.,.,.,.,.,.,,.,.,.,.,.,.,.,,.,.,.,.,.,.,.,,.,.,.,.,.,.,.,,.,.,.,.,.,.,.,,.,.,.,.,.,.,.,,.,.,.,.,.,.,.,,.,.,.,.,.,.,.,,.,.,.,.,.,.,.,,.,.,.,.,.,.,.,,.,.,.,.,.,.,.,
FZFZ,.,.,.,.,.,.,.,.,.,..,.,.,.,.,.,.,.,,.,.,.,.,.,.,.,,.,.,.,.,.,.,.,,.,.,.,.,.,.,.,,.,.,.,.,.,.,.,,.,.,.,.,.,.,.,,.,.,.,.,.,.,.,,.,.,.,.,.,.,.,,.,.,.,.,.,.,.,,.,.,.,.,.,.,.,,.,.,.,.,.,.,.,,.,.,.,.,.,.,.,,.,.,.,.,.,.,.,,.,.,.,.,.,.,.,,.,.,.,.,.,.,.,,.,.,.,.,.,.,.,,.,.,.,.,.,.,.,
FZFZ,.,.,.,.,.,.,.,.,.,....,.,.,.,.,.,.,,.,.,.,.,.,.,.,,.,.,.,.,.,.,.,,.,.,.,.,.,.,.,,.,.,.,.,.,.,.,,.,.,.,.,.,.,.,,.,.,.,.,.,.,.,,.,.,.,.,.,.,.,,.,.,.,.,.,.,.,,.,.,.,.,.,.,.,,.,.,.,.,.,.,.,,.,.,.,.,.,.,.,,.,.,.,.,.,.,.,,.,.,.,.,.,.,.,,.,.,.,.,.,.,.,,.,.,.,.,.,.,.,,.,.,.,.,.,.,.,
FZFZ,.,.,.,.,.,.,.,.,.,..,.,.,.,.,.,.,.,,.,.,.,.,.,.,.,,.,.,.,.,.,.,.,,.,.,.,.,.,.,.,,.,.,.,.,.,.,.,,.,.,.,.,.,.,.,,.,.,.,.,.,.,.,,.,.,.,.,.,.,.,,.,.,.,.,.,.,.,,.,.,.,.,.,.,.,,.,.,.,.,.,.,.,,.,.,.,.,.,.,.,,.,.,.,.,.,.,.,,.,.,.,.,.,.,.,,.,.,.,.,.,.,.,,.,.,.,.,.,.,.,,.,.,.,.,.,.,.,
FZFZ,.,.,.,.,.,.,.,.,.,..,.,.,.,.,.,.,.,,.,.,.,.,.,.,.,,.,.,.,.,.,.,.,,.,.,.,.,.,.,.,,.,.,.,.,.,.,.,,.,.,.,.,.,.,.,,.,.,.,.,.,.,.,,.,.,.,.,.,.,.,,.,.,.,.,.,.,.,,.,.,.,.,.,.,.,,.,.,.,.,.,.,.,,.,.,.,.,.,.,.,,.,.,.,.,.,.,.,,.,.,.,.,.,.,.,,.,.,.,.,.,.,.,,.,.,.,.,.,.,.,,.,.,.,.,.,.,.,
FZFZ,.,.,.,.,.,.,.,.,.,..,.,.,.,.,.,.,.,,.,.,.,.,.,.,.,,.,.,.,.,.,.,.,,.,.,.,.,.,.,.,,.,.,.,.,.,.,.,,.,.,.,.,.,.,.,,.,.,.,.,.,.,.,,.,.,.,.,.,.,.,,.,.,.,.,.,.,.,,.,.,.,.,.,.,.,,.,.,.,.,.,.,.,,.,.,.,.,.,.,.,,.,.,.,.,.,.,.,,.,.,.,.,.,.,.,,.,.,.,.,.,.,.,,.,.,.,.,.,.,.,,.,.,.,.,.,.,.,
FZFZ,.,.,.,.,.,.,.,.,.,..,.,.,.,.,.,.,.,,.,.,.,.,.,.,.,,.,.,.,.,.,.,.,,.,.,.,.,.,.,.,,.,.,.,.,.,.,.,,.,.,.,.,.,.,.,,.,.,.,.,.,.,.,,.,.,.,.,.,.,.,,.,.,.,.,.,.,.,,.,.,.,.,.,.,.,,.,.,.,.,.,.,.,,.,.,.,.,.,.,.,,.,.,.,.,.,.,.,,.,.,.,.,.,.,.,,.,.,.,.,.,.,.,,.,.,.,.,.,.,.,,.,.,.,.,.,.,.,
FZFZ,.,.,.,.,.,.,.,.,.,..,.,.,.,.,.,.,.,,.,.,.,.,.,.,.,,.,.,.,.,.,.,.,,.,.,.,.,.,.,.,,.,.,.,.,.,.,.,,.,.,.,.,.,.,.,,.,.,.,.,.,.,.,,.,.,.,.,.,.,.,,.,.,.,.,.,.,.,,.,.,.,.,.,.,.,,.,.,.,.,.,.,.,,.,.,.,.,.,.,.,,.,.,.,.,.,.,.,,.,.,.,.,.,.,.,,.,.,.,.,.,.,.,,.,.,.,.,.,.,.,,.,.,.,.,.,.,.,
FZFZ,.,.,.,.,.,.,.,.,.,..,.,.,.,.,.,.,.,,.,.,.,.,.,.,.,,.,.,.,.,.,.,.,,.,.,.,.,.,.,.,,.,.,.,.,.,.,.,,.,.,.,.,.,.,.,,.,.,.,.,.,.,.,,.,.,.,.,.,.,.,,.,.,.,.,.,.,.,,.,.,.,.,.,.,.,,.,.,.,.,.,.,.,,.,.,.,.,.,.,.,,.,.,.,.,.,.,.,,.,.,.,.,.,.,.,,.,.,.,.,.,.,.,,.,.,.,.,.,.,.,,.,.,.,.,.,.,.,
FZFZ,.,.,.,.,.,.,.,.,.,..,.,.,.,.,.,.,.,,.,.,.,.,.,.,.,,.,.,.,.,.,.,.,,.,.,.,.,.,.,.,,.,.,.,.,.,.,.,,.,.,.,.,.,.,.,,.,.,.,.,.,.,.,,.,.,.,.,.,.,.,,.,.,.,.,.,.,.,,.,.,.,.,.,.,.,,.,.,.,.,.,.,.,,.,.,.,.,.,.,.,,.,.,.,.,.,.,.,,.,.,.,.,.,.,.,,.,.,.,.,.,.,.,,.,.,.,.,.,.,.,,.,.,.,.,.,.,.,
FZFZ,.,.,.,.,.,.,.X.,,X..,.,.,.,.,.,.,.,,.,.,.,.,.,.,.,,.,.,.,.,.,.,.,,.,.,.,.,.,.,.,,.,.,.,.,.,.,.,,.,.,.,.,.,.,.,,.,.,.,.,.,.,.,,.,.,.,.,.,.,.,,.,.,.,.,.,.,.,,.,.,.,.,.,.,.,,.,.,.,.,.,.,.,,.,.,.,.,.,.,.,,.,.,.,.,.,.,.,,.,.,.,.,.,.,.,,.,.,.,.,.,.,.,,.,.,.,.,.,.,.,,.,.,.,.,.,.,.,
FZFZ,.,.,.,.,.,.,.,.@.,..,.,.,.,.,.,.,.,,.,.,.,.,.,.,.,,.,.,.,.,.,.,.,,.,.,.,.,.,.,.,,.,.,.,.,.,.,.,,.,.,.,.,.,.,.,,.,.,.,.,.,.,.,,.,.,.,.,.,.,.,,.,.,.,.,.,.,.,,.,.,.,.,.,.,.,,.,.,.,.,.,.,.,,.,.,.,.,.,.,.,,.,.,.,.,.,.,.,,.,.,.,.,.,.,.,,.,.,.,.,.,.,.,,.,.,.,.,.,.,.,,.,.,.,.,.,.,.,
FZFZ,.,.,.,.,.,.,.,.,.,..,.,.,.,.,.,.,.,,.,.,.,.,.,.,.,,.,.,.,.,.,.,.,,.,.,.,.,.,.,.,,.,.,.,.,.,.,.,,.,.,.,.,.,.,.,,.,.,.,.,.,.,.,,.,.,.,.,.,.,.,,.,.,.,.,.,.,.,,.,.,.,.,.,.,.,,.,.,.,.,.,.,.,,.,.,.,.,.,.,.,,.,.,.,.,.,.,.,,.,.,.,.,.,.,.,,.,.,.,.,.,.,.,,.,.,.,.,.,.,.,,.,.,.,.,.,.,.,
FZFZ,.,.,.,.,.,.,.,.,.,..,.,.,.,.,.,.,.,,.,.,.,.,.,.,.,,.,.,.,.,.,.,.,,.,.,.,.,.,.,.,,.,.,.,.,.,.,.,,.,.,.,.,.,.,.,,.,.,.,.,.,.,.,,.,.,.,.,.,.,.,,.,.,.,.,.,.,.,,.,.,.,.,.,.,.,,.,.,.,.,.,.,.,,.,.,.,.,.,.,.,,.,.,.,.,.,.,.,,.,.,.,.,.,.,.,,.,.,.,.,.,.,.,,.,.,.,.,.,.,.,,.,.,.,.,.,.,.,
FZFFZFZFFZFZFFZFZFFZFZFFZFZFZFFZFZFFZFZFFZFZFZFFZFZFFZFZFFZFZFZFFZFZFFZFZFFZFZFZFFZFZFFZFZFFZFZFZFFZFZFFZFZFFZFZFZFFZFZFFZFZFFZFZFZFFZFZFFZFZFFZFZFZFFZFZFFZFZFFZFZFZFFZFZFFZFZFFZFZFZFFZFZFFZFZFFZFZFZFFZFZFFZFZFFZFZFZFFZFZFFZFZFFZFZFZFFZFZFFZFZFFZFZFZFFZFZFFZFZFFZFZFZFFZFZFFZFZFFZ
FZFFZFZFFZFZFFZFZFFZFZFFZFZFFZFZFFZFZFFZFZFFZFZFFZFZFFZFZFFZFZFFZFZFFZFZFFZFZFFZFZVVVVVVVVVVVVVVVVVVVVVVVVVVVVVVVVVVVVVVVVVVVVVVVVVVVVVVVVVVVVVVVVVVVVVVVVVVVVVVVVVVVVVVVVVVVVVVVVVVVVVVVVVVVVVVVVVVVVVVVVVVVVVVVVVVVVVVVVVVVVVVVVVVVVVVVVVVVVVVVVVVVVVVVVVVVVVVVVVVVVVVVVVVVVVVVVVVVVVV
VVVVVVVVVVVVVVVVVVVVVVVVVVVVVVVVVVVVVVVVVVVVVVVVVVVVVVVVVVVVVVVVVVVVVVVVVVVVVVVVVVVVVVVVVVVVVVVVVVVVVVVVVVVVVVVVVVVVVVVVVVVVVVVVVVVVVVVVVVVVVVVVVVVVVVVVVVVVVVVVVVVVVVVVVVVVVVVVVVVVVVVVVVVVVVVVVVVVVVVVVVVVVVVVVVVVVVVVVVVVVVVVVVVVVVVVVVVVVVVVVVVVVVVVVVVVVVVVVVVVVVVVVVVVVVVVVVVVVVVV